3 3 3 3 3 3 3 3 3 3 3 3 3 3 3 3 3 3 3 3 3 3 3 3 3 3 3 3 3 3 3 3 3 3 3 3 3 3 3 3 3 3 3 3 3 3 3 3 3 3 3 3 3 3 3 3 3 3 3 3 3 3 3 3 3 3 3 3 3 3 3 3 3 3 3 3 3 3 3 3 3 3 3 3 3 3 3 3 3 3 3 3 3 3 3 3 3 3 3 3 
3 3 3 1 1 1 4 4 3 3 3 3 3 1 1 1 1 1 1 1 1 1 1 1 1 1 1 1 1 1 1 3 3 3 1 1 1 1 1 1 1 1 1 1 1 1 1 1 1 1 1 1 1 1 1 1 1 1 1 1 1 1 1 1 1 1 1 1 1 1 1 1 1 1 1 1 1 1 1 1 1 3 3 3 3 3 3 3 3 3 3 3 3 3 3 3 3 3 3 3 
3 3 1 1 4 4 4 4 4 3 3 3 1 1 1 1 1 1 1 1 1 1 1 1 1 1 1 1 1 1 1 1 3 3 3 1 1 7 7 7 7 7 7 7 7 7 7 5 7 7 7 5 5 1 1 1 1 1 1 1 1 1 1 1 1 1 1 1 1 1 1 1 1 1 1 1 1 7 5 1 1 1 3 3 3 3 3 3 3 3 3 3 3 3 3 3 3 3 3 3 
3 3 1 4 4 4 4 4 4 3 3 1 1 1 5 5 5 5 5 5 5 5 5 5 5 1 1 1 1 1 1 1 1 3 3 3 1 7 7 7 7 7 7 7 7 7 7 7 7 7 7 5 7 5 5 5 5 5 1 1 1 1 1 1 1 1 1 1 1 1 1 1 1 1 7 7 7 7 5 5 1 1 3 3 3 3 3 3 3 3 3 3 3 3 3 3 3 3 3 3 
3 3 4 4 4 4 4 4 4 3 3 1 1 5 5 5 5 5 5 7 7 5 5 5 5 5 1 1 1 5 5 1 1 3 3 3 7 7 7 5 7 7 7 5 7 7 7 5 5 7 7 5 5 5 7 5 7 5 5 1 1 1 1 1 1 1 1 1 1 7 7 7 7 7 7 7 7 5 7 5 1 1 3 3 3 3 3 0 0 0 0 3 0 0 0 0 3 3 3 3 
3 3 3 4 4 4 4 4 4 3 3 1 1 5 7 7 7 5 5 5 5 5 5 5 7 5 5 5 5 5 5 7 5 5 3 3 3 7 7 7 7 7 5 7 7 7 7 5 5 5 7 5 5 5 7 5 5 5 5 5 1 1 1 1 1 1 1 7 7 7 7 7 7 7 7 5 5 5 5 5 1 1 3 3 3 3 3 0 0 3 3 3 4 4 0 0 0 3 3 3 
3 3 3 3 4 4 4 4 4 3 3 3 1 5 5 5 5 5 5 5 7 7 5 5 5 7 5 5 5 5 5 5 5 5 3 3 3 3 3 7 7 7 7 7 7 7 5 5 5 5 5 7 5 7 5 5 5 5 5 5 5 5 5 5 5 7 7 7 7 7 7 7 7 7 7 5 5 5 5 5 1 3 3 3 3 3 0 0 0 3 3 3 4 2 2 2 2 0 3 3 
3 3 3 3 6 6 4 4 4 4 3 3 1 1 5 5 5 5 7 5 5 7 7 5 5 5 5 7 5 7 7 5 5 7 5 5 3 3 3 3 3 3 3 3 3 3 5 7 5 7 5 5 5 5 5 5 5 7 5 5 7 5 5 5 5 5 5 7 7 7 5 5 5 5 5 5 5 5 5 1 1 3 3 3 0 0 0 0 0 0 3 4 2 2 2 2 2 0 0 3 
3 3 3 3 6 6 6 3 4 4 3 3 1 1 1 5 5 5 7 5 5 5 5 5 5 5 7 7 5 5 5 5 5 5 5 7 5 5 5 5 5 5 5 3 3 3 3 5 5 5 7 5 5 5 5 5 5 5 5 5 5 5 5 5 5 5 5 5 5 5 5 5 5 7 5 5 5 5 5 1 3 3 3 3 0 0 0 2 0 0 3 4 2 0 0 2 2 0 0 3 
3 2 2 2 2 2 6 3 3 3 3 3 3 1 1 5 5 5 5 5 5 5 5 5 5 5 5 5 5 5 5 5 5 5 5 5 5 5 5 5 5 5 5 5 3 3 3 3 5 5 7 5 5 7 5 5 5 5 7 5 5 5 5 5 5 5 5 5 5 5 5 5 5 5 5 7 5 5 1 1 3 3 3 3 0 0 2 2 2 0 2 2 2 0 0 2 2 0 0 3 
3 0 2 2 2 2 2 3 3 3 3 3 3 1 1 1 5 7 7 5 5 5 5 7 5 5 5 5 5 1 5 5 5 5 5 5 5 5 5 5 5 5 5 5 5 3 3 3 3 3 5 5 5 5 5 5 5 5 5 5 5 5 5 5 5 5 5 5 5 5 5 5 5 5 5 5 5 5 1 1 3 3 3 0 0 2 2 2 2 0 0 2 2 0 0 4 2 0 0 3 
3 0 2 2 2 2 2 0 0 0 3 3 3 3 1 1 1 7 7 7 7 5 5 7 5 5 5 7 5 5 5 5 5 5 5 5 1 5 7 5 5 7 5 5 5 5 3 3 3 3 5 5 5 5 5 5 5 5 5 5 5 5 5 5 5 5 5 5 5 5 5 5 5 5 5 5 5 5 1 1 3 3 3 0 0 2 2 2 2 2 0 2 2 0 0 2 2 0 0 3 
3 3 0 2 2 2 2 2 2 2 2 3 3 3 3 1 1 1 7 7 7 5 5 5 5 5 5 5 5 5 5 5 5 5 5 5 5 5 5 5 5 5 5 5 5 5 5 3 3 3 3 7 7 5 5 5 5 5 7 5 5 5 7 7 7 5 5 5 5 5 5 5 5 5 5 5 5 1 1 3 3 3 0 0 2 2 2 0 2 2 0 2 2 0 0 2 4 0 0 3 
3 3 3 2 2 2 2 2 2 2 2 3 3 3 3 3 1 1 1 7 7 5 5 5 5 5 5 5 5 5 1 5 5 5 1 1 5 5 5 5 5 5 5 5 5 5 5 3 3 3 3 3 7 7 5 5 5 5 5 5 5 7 7 7 7 7 7 5 5 5 5 5 5 5 5 5 5 1 1 1 3 3 0 4 4 4 2 0 2 2 0 2 2 0 0 2 2 0 0 3 
3 3 3 6 6 6 3 3 6 6 6 6 3 3 3 3 3 1 1 7 7 5 5 5 5 5 7 5 5 5 1 5 5 1 1 1 1 1 5 5 5 5 5 5 5 5 5 5 3 3 3 3 3 7 5 5 5 5 5 7 7 7 7 7 7 7 7 7 5 5 5 5 5 5 5 5 5 1 1 1 1 1 4 4 4 4 4 0 2 2 0 2 2 0 0 2 2 0 0 3 
3 3 3 6 6 6 3 3 3 6 6 6 6 3 3 3 1 1 1 1 5 5 5 5 7 7 7 7 5 5 5 5 1 5 1 1 1 5 5 5 5 5 5 5 7 5 5 5 7 3 3 3 3 7 5 5 5 5 5 7 7 7 3 3 3 3 7 7 7 5 5 5 5 5 5 5 5 1 1 1 1 4 4 4 4 4 4 0 2 2 4 2 2 0 0 2 2 0 0 3 
3 3 3 6 6 4 4 4 3 3 6 6 6 3 0 0 1 1 1 1 1 1 5 5 7 7 7 7 5 5 5 5 1 5 5 5 5 5 5 5 5 5 5 5 5 5 5 5 7 7 3 3 7 7 5 5 5 5 7 7 7 3 3 3 3 3 3 7 7 5 5 7 5 5 7 5 1 1 3 1 1 1 4 4 4 4 4 0 2 2 2 2 2 0 2 2 4 0 3 3 
3 3 2 2 2 4 4 4 4 3 3 6 6 6 0 0 0 1 2 1 1 1 1 7 7 7 7 7 5 5 5 5 5 5 5 5 5 5 5 5 5 5 5 5 5 5 5 5 5 7 7 7 7 5 5 5 5 5 5 7 5 3 3 3 3 3 3 3 3 5 5 5 5 5 5 5 1 1 3 3 3 0 1 4 4 4 0 0 4 2 2 2 2 0 2 2 2 0 3 3 
3 3 0 2 4 4 4 4 4 3 3 6 6 6 2 2 2 2 1 2 1 1 1 7 5 7 7 7 5 5 5 7 5 5 5 5 5 5 5 5 7 5 5 5 5 5 7 5 5 5 5 5 5 5 5 5 5 5 5 5 3 3 3 3 3 3 3 3 3 3 5 5 5 5 5 5 1 1 3 3 3 3 0 0 0 4 0 0 2 4 2 2 0 0 2 4 2 0 3 3 
3 3 0 4 4 4 4 4 0 3 3 3 6 6 2 2 2 1 1 1 1 1 1 1 7 7 7 7 7 5 5 5 5 5 5 5 5 5 7 5 7 5 5 5 5 5 5 5 5 5 5 5 5 5 5 5 5 5 5 5 3 3 3 3 3 3 3 3 3 3 3 5 5 5 5 1 1 3 3 3 3 3 3 3 0 0 0 0 0 0 2 2 0 2 2 2 0 0 3 3 
3 3 3 4 4 4 3 3 3 3 3 3 3 6 2 2 2 2 1 2 1 1 1 1 7 7 7 7 7 7 5 5 5 7 5 5 5 7 5 5 5 5 5 5 5 5 5 5 5 5 5 5 5 5 5 5 5 5 5 5 5 3 3 3 3 3 5 5 3 3 3 3 3 1 1 1 1 3 3 3 3 3 0 3 3 3 3 3 3 3 0 0 0 2 2 2 0 0 3 3 
3 3 3 6 6 6 3 3 3 3 3 3 3 3 3 2 2 2 2 1 0 1 1 1 1 7 5 7 5 7 7 5 5 5 5 5 5 5 5 5 5 5 5 5 5 5 5 5 5 5 5 5 5 5 5 5 5 5 5 5 5 5 3 3 3 5 5 5 5 3 3 3 3 3 1 1 3 3 3 3 3 3 3 3 3 3 3 3 3 0 0 0 0 2 2 0 0 0 3 3 
3 3 3 6 6 6 3 1 1 1 3 3 3 3 3 2 2 2 0 0 0 3 3 3 1 1 7 7 7 7 5 5 5 5 5 5 5 5 5 5 5 5 5 5 7 7 5 5 5 7 5 5 5 7 5 5 5 5 5 5 5 5 5 5 5 5 7 5 5 5 5 3 3 3 3 3 3 3 3 3 3 3 3 3 3 3 3 3 3 0 0 0 2 2 2 0 0 0 0 3 
3 3 1 1 1 1 1 1 1 1 3 3 3 3 3 0 0 0 0 0 3 3 3 3 3 1 1 7 7 7 5 5 7 5 5 5 5 5 5 5 5 5 5 5 5 5 5 5 5 5 7 7 5 5 5 5 5 5 5 7 7 5 5 5 5 5 5 5 5 5 5 1 3 3 3 3 3 3 3 3 3 3 3 3 3 3 3 3 3 3 0 2 2 2 4 4 4 4 0 3 
3 4 4 1 1 1 1 1 1 1 3 3 3 3 3 3 3 3 3 3 3 3 3 3 3 3 1 1 7 7 5 5 5 5 5 5 5 5 5 5 5 5 5 5 5 5 5 5 5 5 5 7 7 5 5 5 5 5 5 5 5 5 5 5 5 5 5 7 5 5 5 1 1 3 3 3 3 3 3 3 0 3 3 3 3 3 3 3 3 3 0 2 2 4 4 4 4 0 0 3 
3 4 4 4 4 1 1 1 1 1 6 3 3 3 3 3 3 3 3 3 3 3 3 3 3 3 3 1 1 7 5 5 5 5 5 5 5 5 5 5 5 5 5 5 5 1 1 1 1 1 1 1 1 1 1 1 1 1 1 1 1 5 5 5 5 5 5 5 5 5 5 1 1 3 3 3 3 3 0 0 0 0 0 0 0 3 3 3 3 3 0 2 2 4 2 0 0 0 0 3 
3 2 4 4 4 4 1 1 1 6 6 6 3 3 3 3 3 3 3 3 3 3 3 3 3 3 3 1 1 7 5 5 5 5 5 5 5 5 5 5 5 5 1 1 1 1 3 3 3 3 3 3 3 3 3 3 3 3 1 1 1 1 1 1 5 5 5 5 5 5 5 1 1 3 3 3 3 0 0 2 2 2 0 0 0 3 3 3 3 3 0 2 2 2 0 0 0 2 0 3 
3 0 2 2 4 4 4 1 1 6 6 6 6 3 3 3 4 4 4 4 3 3 3 3 3 3 3 3 1 7 5 5 5 5 5 5 7 5 5 5 7 1 1 3 3 3 3 3 3 3 3 3 3 3 3 3 3 3 3 3 3 1 1 1 1 5 5 5 5 5 1 1 3 3 3 3 3 0 0 0 2 2 0 0 0 0 0 0 0 0 0 2 2 0 0 0 2 0 0 3 
3 3 2 2 2 2 2 2 3 3 6 6 6 6 3 2 2 2 4 4 4 4 3 3 3 3 3 3 3 7 7 7 5 7 5 5 5 5 7 7 1 1 3 3 3 3 3 7 7 7 7 3 3 3 7 7 7 7 7 3 3 3 3 3 1 1 1 1 1 1 1 3 3 3 3 3 0 0 0 0 0 2 2 2 4 4 4 0 0 0 0 2 2 2 2 2 2 2 0 3 
3 3 3 2 2 0 2 3 3 3 3 6 6 2 2 0 2 2 2 2 4 4 3 3 3 3 3 3 3 3 5 7 7 7 7 7 7 7 7 1 1 3 3 3 3 3 7 0 5 5 5 3 3 3 5 7 7 7 7 7 7 3 3 3 3 3 3 3 3 3 3 3 3 3 3 0 4 4 4 4 0 0 2 2 2 4 4 2 0 0 2 2 2 2 2 2 2 2 0 3 
3 3 3 3 3 3 3 3 3 3 3 3 3 2 2 2 2 2 0 2 2 3 3 3 3 3 3 3 3 3 3 7 7 7 7 7 7 7 7 1 3 3 3 3 7 7 7 5 5 5 5 3 3 3 5 5 7 5 7 7 7 7 7 3 3 3 3 3 3 3 3 3 3 3 0 0 4 0 4 4 4 0 2 2 2 0 4 4 4 0 2 2 2 2 2 2 2 0 0 3 
3 3 3 3 3 3 3 3 3 3 6 6 6 2 2 2 2 2 2 2 6 6 3 3 3 3 3 3 3 3 3 3 3 7 1 1 1 1 1 3 3 3 7 7 7 5 5 5 5 3 3 3 3 3 5 5 5 5 5 5 7 7 7 7 7 3 3 3 3 3 3 3 3 0 0 0 4 0 0 4 4 0 2 4 0 0 4 4 4 0 0 2 2 2 2 2 2 0 0 3 
3 3 3 3 3 3 3 3 3 6 6 6 6 3 3 2 2 2 2 6 6 6 6 6 3 3 3 3 3 3 3 3 3 3 3 1 1 1 3 3 0 7 7 5 5 5 5 1 7 3 3 3 3 3 5 1 2 2 7 2 5 5 7 7 7 7 3 3 3 3 3 3 0 0 0 2 2 2 0 0 2 0 4 4 0 0 4 4 4 0 0 2 2 2 0 2 2 0 0 3 
3 3 3 3 4 4 4 4 6 6 6 6 3 3 3 6 6 6 3 3 6 6 6 6 1 1 1 3 3 3 3 3 3 3 3 3 3 3 3 7 7 7 5 5 7 5 5 5 7 5 3 3 3 3 1 1 2 7 2 2 2 5 5 2 7 7 0 3 3 3 3 3 0 0 0 2 2 2 0 0 2 0 4 4 0 4 4 4 0 0 0 2 2 2 2 2 2 0 0 3 
3 3 3 1 4 4 4 4 4 6 6 3 3 3 3 6 6 6 3 3 3 6 6 1 1 1 1 1 1 1 3 3 3 3 3 3 3 7 7 7 5 5 5 5 5 5 1 5 5 7 3 3 7 1 1 2 2 2 2 2 2 2 2 2 2 0 0 0 0 0 3 3 3 0 0 2 2 2 0 2 2 2 4 4 0 0 4 4 0 2 0 0 2 2 2 2 2 0 0 3 
3 3 3 1 4 4 4 4 4 6 3 3 3 3 3 6 6 6 3 3 3 3 6 1 1 1 1 1 1 1 1 3 3 3 3 3 3 7 5 5 1 5 5 5 5 7 2 2 2 5 5 5 5 5 5 2 2 2 2 2 2 2 2 2 2 2 2 0 2 1 3 3 3 3 0 0 0 0 2 2 2 2 4 4 2 0 4 4 0 0 0 0 0 2 2 2 2 0 0 3 
3 3 1 1 4 4 4 4 4 3 3 3 3 3 3 6 6 6 3 3 3 3 3 1 1 1 1 1 1 1 1 4 3 3 3 3 7 7 5 5 5 5 5 2 2 2 2 2 2 2 2 2 2 2 2 2 2 2 2 2 2 4 4 2 2 0 0 0 2 1 1 3 3 3 3 0 2 0 4 2 0 0 0 2 2 0 4 4 0 0 0 0 0 2 2 2 2 0 3 3 
3 1 1 4 4 4 4 4 4 3 3 3 3 4 4 4 4 6 3 3 3 3 3 3 1 1 1 1 4 4 4 3 3 3 3 3 5 5 5 7 2 2 2 0 2 2 2 2 2 2 2 2 2 2 2 2 2 2 2 2 2 4 4 4 2 0 0 0 2 2 1 1 3 3 3 3 0 4 4 0 0 0 2 2 2 0 4 2 0 0 0 0 0 1 2 2 2 0 3 3 
3 4 4 4 4 4 4 4 4 3 3 3 4 4 4 4 4 4 4 3 3 3 3 3 3 1 1 1 4 4 3 3 3 3 3 3 3 5 5 2 2 2 2 2 2 2 2 2 0 0 0 0 0 0 0 0 2 2 2 2 2 2 4 4 4 0 0 2 2 2 2 1 3 3 3 3 0 4 4 0 2 2 2 2 0 2 2 2 2 2 2 2 1 1 1 1 2 0 3 3 
3 4 4 4 4 4 4 4 3 3 3 4 4 4 4 4 4 4 4 4 3 3 3 3 3 3 3 3 3 3 3 3 3 0 0 3 3 3 3 2 0 2 2 2 2 2 0 0 0 2 2 0 2 2 2 0 0 0 0 2 2 2 0 4 4 4 4 2 4 2 2 1 1 1 3 3 3 0 4 4 4 4 0 0 0 4 2 2 4 2 2 1 1 1 1 1 0 0 3 3 
3 3 4 4 4 4 4 3 3 3 4 4 2 2 2 4 4 4 4 4 6 6 6 3 3 3 3 3 3 3 3 3 3 0 2 0 0 0 3 2 2 2 2 2 2 0 0 2 2 2 2 2 2 2 2 2 2 2 0 0 0 2 0 0 4 4 4 2 2 2 2 2 2 1 3 3 3 0 0 4 4 0 0 0 2 2 2 4 2 2 2 1 1 1 1 1 0 0 3 3 
3 3 4 4 3 3 3 3 3 3 4 4 2 2 2 2 2 2 4 4 6 6 6 6 3 3 3 3 0 0 0 0 0 0 2 2 0 0 3 3 2 2 4 2 0 0 3 3 3 3 2 2 2 2 2 2 2 2 2 2 0 0 0 2 4 4 4 4 2 4 2 2 2 1 1 3 3 3 0 0 0 0 2 2 2 2 2 2 0 0 0 1 1 1 1 0 2 0 3 3 
3 3 3 3 3 3 3 3 3 3 4 4 4 2 2 2 2 2 2 3 3 6 6 6 6 6 2 2 2 0 0 0 0 2 2 2 2 3 3 0 0 4 4 0 0 2 3 3 3 3 3 2 2 0 0 2 2 2 2 0 2 0 0 2 2 2 2 2 2 2 2 2 2 2 1 1 3 3 0 0 0 2 2 2 2 2 2 2 0 0 0 1 1 1 0 0 2 0 3 3 
3 3 3 3 3 1 1 3 3 3 3 4 4 4 2 2 2 2 3 3 3 3 3 6 6 6 2 2 2 2 0 0 2 2 2 2 3 3 2 0 2 4 2 0 2 2 3 3 3 3 3 2 2 2 2 2 0 2 2 2 2 2 0 2 4 2 2 4 2 2 2 2 2 2 2 1 3 3 0 0 2 2 2 0 0 2 2 2 0 0 0 0 0 0 0 0 0 3 3 3 
3 3 3 1 1 1 1 1 3 3 3 3 3 3 3 3 3 3 3 3 3 3 3 3 3 3 2 2 2 2 0 0 2 2 2 3 3 3 2 2 4 4 0 0 2 2 3 3 3 3 3 2 2 2 2 2 2 2 2 2 2 2 0 0 2 2 2 2 2 2 4 2 2 2 0 0 3 3 3 0 2 2 0 0 2 2 2 2 0 0 0 0 3 3 3 3 3 3 3 3 
3 3 1 1 1 1 1 1 6 6 6 6 3 3 3 3 3 3 3 3 3 3 3 3 3 3 6 2 2 2 0 0 2 2 3 3 2 1 1 4 4 4 0 2 2 2 2 3 3 3 2 2 2 2 2 0 0 2 2 2 2 2 2 0 2 2 2 4 2 2 2 2 0 0 0 0 3 3 3 0 0 0 0 0 2 2 2 0 0 0 3 3 3 3 3 3 3 3 3 3 
3 3 1 1 1 1 1 1 6 6 6 6 6 6 3 3 3 3 2 2 3 3 3 3 3 6 6 6 6 3 3 0 2 2 3 2 2 2 1 2 2 0 0 2 2 2 2 2 2 2 2 2 2 2 2 2 2 2 2 2 0 2 2 0 0 2 2 2 2 2 2 0 0 0 0 0 0 3 3 0 0 0 0 2 2 2 2 0 0 3 3 3 3 3 3 3 3 0 3 3 
3 3 1 1 1 1 1 6 3 3 6 6 6 6 6 6 6 2 2 2 2 2 2 3 6 6 6 6 3 3 3 0 2 2 2 2 2 2 3 2 2 0 0 2 2 2 2 2 2 2 2 2 2 2 2 2 2 2 2 2 2 0 2 2 0 2 2 2 2 0 0 0 0 0 0 2 1 3 3 3 0 0 0 2 2 2 2 0 3 3 3 3 3 3 3 3 0 0 3 3 
3 3 6 1 1 1 1 6 6 3 3 3 6 6 6 6 6 2 2 2 2 2 0 2 2 2 6 3 3 3 0 0 2 2 2 2 3 3 3 3 2 0 0 2 2 2 2 2 2 0 2 2 2 2 2 2 2 0 2 2 2 2 2 2 0 2 2 2 2 0 0 0 0 0 0 2 1 3 3 3 0 0 2 2 2 2 2 0 3 3 3 3 3 3 3 2 0 0 3 3 
3 3 6 6 6 3 6 6 6 6 3 3 3 3 6 6 6 6 2 2 2 2 2 2 2 2 4 4 3 3 0 2 2 2 2 6 6 2 2 3 3 0 0 2 0 2 2 2 2 2 2 2 2 2 2 2 2 2 2 2 3 3 3 2 0 0 2 2 2 0 0 2 2 0 0 2 1 1 3 3 0 2 2 2 2 2 2 0 3 3 3 3 3 3 3 0 0 0 3 3 
3 3 6 6 6 3 3 6 6 6 6 3 3 3 3 3 3 3 3 0 2 2 2 2 2 2 4 4 3 3 1 2 2 2 2 6 6 2 2 2 3 0 0 2 2 2 2 2 2 2 2 2 2 2 2 2 2 2 2 2 3 3 3 2 2 0 2 2 2 2 2 2 2 2 2 2 2 1 3 3 0 2 2 2 2 2 0 0 3 3 3 3 3 3 0 0 2 0 0 3 
3 3 6 6 6 3 3 3 6 6 6 6 3 3 3 3 3 3 3 3 2 2 2 2 2 2 4 4 3 3 1 2 2 2 2 6 6 6 2 2 3 0 0 2 2 0 2 2 2 2 2 2 2 2 2 2 2 2 2 2 3 3 2 2 2 0 0 2 2 2 2 2 2 2 2 2 2 0 3 3 3 2 2 2 2 2 0 0 0 3 3 3 3 3 0 2 2 0 0 3 
0 0 2 6 6 3 3 3 3 6 6 6 4 4 4 4 3 3 3 3 3 0 2 2 2 4 4 4 3 3 1 2 2 3 3 3 3 3 1 1 3 0 0 0 2 2 2 2 2 0 2 2 2 2 2 2 2 2 2 2 2 2 2 2 2 0 0 0 2 2 2 2 2 2 2 2 2 0 3 3 3 2 2 2 2 0 0 0 2 0 0 3 3 2 0 2 2 2 0 3 
0 2 2 2 2 2 3 3 3 6 6 4 4 4 4 4 4 3 3 3 3 2 2 2 2 4 4 0 3 3 3 3 3 3 3 3 3 3 1 2 3 2 0 0 0 2 2 0 2 2 2 2 2 2 2 2 2 2 2 2 2 2 2 2 0 0 2 0 0 0 2 2 2 2 2 2 2 0 3 3 3 2 2 2 2 0 0 2 2 0 0 0 0 0 2 2 2 0 0 3 
0 0 2 2 2 2 3 3 3 3 3 4 4 4 4 4 4 3 3 3 3 2 2 2 2 4 4 0 3 3 3 3 3 2 2 3 2 2 2 2 3 2 2 0 0 2 2 2 2 2 2 2 2 2 2 2 2 2 2 2 2 2 2 2 2 2 2 2 0 0 2 2 2 2 2 2 0 1 3 3 0 2 2 2 2 2 2 2 2 2 2 2 2 2 2 2 2 0 2 3
0 2 2 2 2 2 3 3 3 3 6 6 4 4 4 4 4 6 3 3 3 3 2 2 2 0 0 0 3 3 3 1 2 2 2 4 2 2 2 2 3 2 2 2 0 0 2 2 2 2 0 2 2 0 2 2 2 2 2 2 2 2 2 2 2 2 2 0 0 0 2 2 2 2 2 2 1 3 3 3 0 0 0 2 2 2 2 2 2 2 2 2 2 2 2 2 2 0 0 3
0 2 0 2 2 3 3 3 6 6 6 6 3 4 4 4 6 6 6 3 3 3 3 0 0 0 0 3 3 3 3 1 2 2 2 4 2 2 2 3 3 2 2 3 3 0 0 0 2 2 2 2 2 2 2 2 2 2 2 2 2 2 0 2 2 2 2 0 0 0 2 2 2 2 2 1 1 3 3 1 1 0 0 0 0 2 2 2 2 2 2 2 2 2 2 2 2 0 0 3 
0 0 2 2 3 3 3 6 6 6 6 3 3 6 6 6 3 6 6 6 6 3 3 3 3 3 3 3 3 3 3 1 2 2 2 3 3 3 3 3 2 2 4 4 3 3 3 0 0 0 2 2 2 2 2 2 2 2 2 2 0 0 0 2 2 2 2 2 0 2 2 2 2 0 1 1 3 3 3 1 1 1 0 0 0 0 0 0 0 0 0 2 2 2 2 2 0 0 2 3 
3 3 3 3 3 3 6 6 6 6 3 3 3 6 6 6 3 3 3 6 6 6 3 3 3 3 3 3 3 3 3 1 2 2 2 3 3 3 2 2 2 2 4 4 4 2 3 3 3 0 0 0 0 0 0 0 0 0 0 0 0 2 2 2 2 2 2 2 2 2 2 2 2 0 1 3 3 3 1 1 1 1 6 3 3 0 0 0 0 0 0 0 2 2 2 2 0 0 0 3 
3 3 3 3 3 3 6 6 6 3 3 1 1 1 1 6 3 3 3 3 6 6 4 4 4 3 3 3 3 3 1 1 2 2 2 3 3 3 2 2 2 2 4 4 4 2 2 2 3 3 3 3 3 3 3 3 3 3 3 0 2 2 2 2 2 2 2 2 2 2 2 2 1 1 3 3 3 3 1 1 1 6 6 3 3 3 3 0 0 0 0 0 2 2 2 2 0 0 3 3 
3 3 3 3 2 2 2 2 2 3 3 1 1 1 1 1 1 3 3 3 6 4 4 4 4 4 3 3 3 3 1 1 2 2 2 2 3 3 6 2 2 2 3 3 2 2 2 2 2 0 2 2 3 3 3 3 3 3 3 0 0 2 2 2 2 2 2 0 0 2 2 1 0 3 3 3 3 1 1 1 6 3 3 3 3 3 3 0 2 0 0 2 2 2 2 2 0 0 3 3 
3 3 2 2 2 2 2 2 2 3 3 1 1 1 1 1 1 6 6 3 4 4 4 4 4 4 4 3 3 3 3 1 0 2 2 2 6 6 6 2 2 2 2 3 3 3 2 2 2 2 2 2 2 0 2 2 2 0 0 0 0 0 2 2 2 2 2 0 2 2 1 1 3 3 3 3 1 1 1 1 6 3 3 3 3 3 3 0 0 0 0 2 2 2 2 0 0 0 3 3 
3 3 2 2 0 2 2 2 2 3 3 1 1 1 1 1 6 6 4 4 4 4 4 4 4 4 4 3 3 3 3 3 0 0 2 2 2 6 6 6 3 2 2 3 3 3 3 2 2 2 2 2 2 2 2 2 2 2 2 2 0 0 0 2 0 2 2 2 2 1 0 3 3 3 3 1 1 1 1 6 3 3 3 3 3 3 3 0 2 2 0 2 2 2 2 2 0 0 3 3 
3 3 2 2 2 2 0 2 6 6 3 3 3 1 1 1 6 6 4 4 4 4 4 4 4 4 6 6 6 3 3 2 2 0 0 2 2 2 2 6 3 3 3 3 2 2 3 3 2 2 2 2 2 2 2 2 2 2 2 2 2 0 0 0 2 2 2 2 1 1 3 3 3 3 1 1 1 1 1 6 3 3 3 3 3 3 3 0 0 0 0 0 2 2 2 2 0 0 3 3 
3 3 3 2 2 2 2 2 6 6 6 6 3 3 3 3 3 3 4 4 4 4 4 4 4 4 6 6 6 6 2 2 2 2 0 0 0 2 2 2 2 2 2 2 2 2 2 3 3 2 2 2 2 2 2 2 2 2 2 2 2 2 0 0 0 0 1 1 1 3 3 3 3 0 0 0 2 0 0 0 3 3 3 3 3 3 2 0 0 0 0 0 2 2 2 2 0 0 3 3 
3 3 3 3 6 6 6 3 6 6 6 6 6 6 6 3 3 3 3 4 4 4 4 1 1 3 6 6 6 6 2 2 2 2 2 0 0 1 1 2 2 2 2 2 2 2 2 3 3 2 2 2 2 2 2 2 2 2 1 1 1 1 0 1 3 3 3 3 3 3 3 3 0 0 0 0 0 0 0 0 0 0 0 0 0 0 0 0 0 0 0 0 2 2 2 2 2 0 3 3 
3 3 3 3 6 6 6 3 3 3 6 6 6 6 6 6 6 3 3 3 1 1 1 1 1 3 3 6 6 2 2 2 2 0 2 2 3 3 1 1 1 1 0 0 2 2 2 3 3 0 1 1 1 1 1 1 1 1 1 3 3 3 3 3 3 3 3 3 3 0 0 0 0 0 2 0 2 2 2 0 0 0 2 2 0 0 0 0 0 0 2 0 2 2 2 2 2 0 3 3 
3 3 3 3 6 6 6 3 3 3 3 3 6 6 6 6 6 6 6 3 3 3 3 3 3 3 3 3 3 2 2 2 2 2 2 0 3 3 3 3 3 3 1 1 1 0 1 1 1 1 3 3 3 3 3 1 1 1 3 3 3 3 3 3 3 3 3 3 0 0 0 0 2 0 0 0 0 2 2 2 0 0 0 0 0 2 0 0 2 0 2 2 2 2 2 2 0 0 3 3 
3 3 3 3 4 4 4 4 4 4 4 3 3 3 6 6 6 6 6 3 3 3 3 3 3 3 3 3 3 0 0 0 2 2 2 3 3 3 3 3 3 3 3 3 3 3 3 3 3 3 3 3 3 3 3 1 1 1 1 3 3 3 3 3 3 3 3 3 0 0 0 2 2 2 0 0 0 0 2 2 2 2 2 0 0 0 0 0 0 0 2 2 2 2 2 2 2 2 2 3 
3 3 4 4 4 4 4 4 4 4 4 4 3 3 3 3 2 2 2 2 2 2 2 2 2 3 3 3 3 3 3 3 3 3 3 3 3 3 3 3 3 3 3 3 3 3 3 3 3 3 3 3 3 3 3 1 1 1 1 1 0 0 0 3 3 3 3 3 0 0 0 0 2 2 2 0 0 0 2 2 2 2 2 0 0 0 0 2 0 2 0 2 2 2 2 2 2 1 1 3 
3 3 4 4 4 4 4 4 4 4 4 4 3 3 3 3 2 1 2 2 2 2 2 1 2 3 3 3 3 3 3 3 3 3 3 1 1 1 1 1 3 3 3 0 0 0 0 0 0 0 0 0 0 0 0 1 1 1 4 4 0 0 0 3 3 3 3 3 0 0 0 2 2 2 2 2 0 0 0 2 2 2 2 2 0 0 0 0 0 0 0 2 0 2 2 2 2 1 1 3 
3 3 3 4 4 4 4 4 3 3 3 3 3 3 3 3 3 2 2 2 2 2 2 2 2 3 3 3 3 3 3 3 3 1 1 0 0 0 0 1 1 3 3 3 0 0 0 0 0 0 0 0 0 4 4 4 4 1 4 4 0 0 0 0 3 3 3 3 0 0 0 0 2 2 2 2 2 0 0 2 2 2 2 0 0 0 0 0 0 0 0 0 2 0 0 0 2 1 1 3 
3 3 3 3 3 3 3 3 3 3 3 3 3 3 3 3 3 2 2 1 2 1 2 2 3 3 3 3 3 3 1 1 1 0 0 0 0 0 0 0 1 3 3 3 3 0 0 0 0 0 0 0 0 4 4 4 4 4 4 4 0 0 0 0 0 3 3 3 3 0 0 0 2 2 2 2 2 2 0 0 2 2 2 0 0 2 0 0 0 0 0 0 0 0 0 0 0 1 1 3 
3 3 3 1 1 1 1 1 1 1 1 1 1 1 3 3 3 1 2 2 2 2 1 3 3 3 3 3 3 3 1 0 0 0 2 2 2 2 2 0 1 1 3 3 3 3 0 0 0 0 0 0 4 4 4 4 4 4 4 4 4 0 0 0 3 3 3 3 3 3 3 0 0 2 2 2 2 2 2 2 2 2 2 2 2 0 0 2 0 0 2 0 0 0 0 2 4 1 1 3 
3 1 1 0 0 0 0 0 0 0 0 0 0 1 3 3 3 2 2 2 1 1 1 3 3 3 1 1 1 1 1 0 2 0 2 0 0 0 2 0 0 1 1 3 3 3 0 0 0 0 0 4 4 4 4 4 4 4 4 4 4 0 0 0 3 3 3 3 3 3 3 3 0 2 2 2 2 2 2 2 2 2 2 2 0 0 0 0 0 0 2 2 2 2 2 4 4 1 1 3 
3 1 0 0 2 2 2 2 2 2 2 2 0 0 1 1 1 2 1 1 2 1 3 3 3 1 0 0 0 0 0 0 2 0 2 0 2 0 2 0 0 0 0 1 3 3 3 0 0 0 4 4 4 4 4 4 4 4 2 2 4 4 0 0 3 3 3 3 3 3 3 3 0 0 2 2 2 2 2 0 0 2 2 2 2 2 2 2 2 2 2 2 2 2 4 4 1 1 1 3 
3 1 0 0 0 0 0 0 0 0 0 2 0 0 0 0 1 1 1 1 1 1 1 1 1 1 0 2 2 2 2 2 2 0 2 0 2 0 2 0 0 2 0 1 3 3 3 0 0 4 2 2 4 2 2 2 2 2 4 2 2 2 0 0 3 3 3 3 3 3 3 3 0 0 0 2 2 2 0 0 0 0 2 2 2 2 2 2 2 2 2 2 4 4 4 1 1 1 1 3 
3 1 0 2 2 2 2 0 2 2 2 2 2 2 2 2 0 0 1 1 0 0 0 0 0 0 0 2 0 0 0 0 2 0 2 2 2 0 2 0 0 2 0 1 3 3 3 0 0 2 2 2 2 2 4 2 2 2 2 4 2 4 0 0 3 3 3 3 3 3 3 3 0 0 0 2 2 2 2 2 0 2 0 0 2 2 2 2 2 2 2 2 4 4 1 1 1 1 1 3 
1 0 0 0 2 0 2 0 2 0 0 0 0 0 0 0 0 0 2 2 0 2 2 2 2 2 2 2 2 2 2 0 2 2 2 0 2 0 2 0 0 2 0 1 3 3 0 0 0 2 2 2 2 2 2 2 2 2 2 2 2 0 2 0 0 3 3 3 3 3 3 0 0 0 2 2 2 2 2 2 2 2 0 0 0 0 2 2 2 2 2 4 4 1 1 1 1 1 1 3 
1 0 0 0 2 0 2 0 2 2 2 2 2 2 2 2 2 2 2 2 0 2 0 0 0 0 0 0 0 0 0 0 2 0 0 0 2 0 2 2 2 2 0 1 3 3 0 0 0 2 0 2 2 2 2 2 2 2 2 2 2 2 0 2 0 0 3 3 3 3 3 0 2 0 0 2 2 2 2 2 2 2 2 0 0 0 2 2 0 0 4 4 1 1 1 1 1 1 1 3 
1 0 2 0 2 0 2 0 0 0 0 0 0 0 0 0 0 0 2 2 0 0 0 0 2 2 2 2 2 2 2 2 2 0 0 0 0 0 2 0 0 0 0 1 3 0 0 0 2 2 2 2 2 2 2 2 2 2 2 0 2 2 0 2 2 2 0 0 0 0 0 0 0 0 0 0 0 2 2 2 2 2 2 0 0 2 0 0 0 0 4 1 1 1 1 1 1 2 2 3 
1 0 2 0 2 0 2 2 2 2 2 2 2 2 2 2 2 0 2 2 0 2 2 2 2 0 0 0 0 0 0 0 0 2 2 2 2 2 2 0 0 0 1 3 3 0 0 2 2 2 2 2 2 2 2 2 2 2 2 2 2 2 0 2 2 2 2 2 2 2 2 2 2 2 2 0 0 0 2 2 2 2 2 0 0 0 0 0 0 0 4 1 1 1 1 1 2 2 0 3 
1 0 2 0 2 0 0 0 0 2 0 0 0 0 0 0 0 0 2 2 0 0 0 0 2 0 2 2 2 2 2 2 2 2 0 0 0 0 0 0 0 0 3 3 3 0 2 2 2 2 2 2 2 2 2 2 2 2 2 2 2 0 2 2 2 2 4 4 4 4 4 4 4 2 2 2 0 0 2 2 2 2 2 0 0 0 0 2 0 0 4 1 1 1 1 2 2 0 0 3 
1 0 2 2 2 0 2 2 2 2 2 2 2 2 2 2 2 2 2 2 2 2 2 0 2 0 2 0 0 0 0 0 2 0 0 0 0 0 2 2 2 0 3 3 3 0 0 2 2 0 2 2 2 2 2 2 2 2 2 2 0 2 2 2 2 4 4 4 4 4 4 4 4 4 4 2 0 2 0 2 2 2 2 2 2 2 0 0 0 0 4 1 1 1 1 2 2 2 0 3 
1 0 0 0 0 0 2 0 2 0 0 0 0 0 0 0 0 0 0 0 0 0 2 0 2 0 2 0 0 0 0 0 2 0 2 2 2 0 2 0 0 0 3 3 3 0 0 2 0 2 2 2 2 2 2 2 2 2 2 2 2 2 2 2 2 2 2 2 2 2 2 4 4 4 4 2 2 0 0 0 0 2 2 2 2 2 2 2 2 0 0 4 1 1 1 2 0 2 0 3 
1 0 0 2 2 2 2 0 2 0 2 2 2 2 2 0 0 0 0 0 0 0 2 0 2 0 2 2 2 2 0 0 2 0 2 0 2 2 2 0 0 3 3 3 0 0 0 2 2 2 2 2 2 2 2 2 2 2 2 2 2 2 2 2 0 2 2 0 0 0 0 0 4 4 4 4 2 2 0 2 0 0 0 2 2 2 2 2 2 0 0 4 1 1 1 2 2 2 3 3 
3 1 0 2 0 0 2 0 2 0 0 0 0 0 2 2 2 2 2 2 2 0 0 0 2 0 0 0 0 2 0 0 2 0 2 0 0 0 2 0 1 3 3 3 0 0 0 0 2 2 2 2 2 2 2 2 2 2 2 2 2 2 2 0 0 0 0 3 3 3 3 3 0 4 4 4 4 2 2 2 0 0 2 2 2 2 2 0 2 0 0 0 4 4 1 1 1 2 3 3 
3 1 0 2 0 0 2 0 2 0 0 0 0 0 2 0 0 0 0 0 0 2 2 2 2 0 0 0 0 2 0 0 2 0 2 0 2 2 2 0 1 3 3 3 0 0 0 0 0 2 0 2 2 2 2 2 2 0 2 2 2 2 2 0 0 0 3 3 3 3 3 3 3 0 4 4 4 2 2 2 2 2 2 2 2 2 2 2 2 2 0 0 0 4 4 1 1 1 3 3 
3 1 0 2 0 2 2 0 2 2 2 2 2 2 2 2 2 2 2 2 2 2 0 0 0 0 2 2 2 2 0 0 2 0 2 0 2 0 0 0 1 3 3 4 0 0 0 0 0 2 2 2 2 2 2 2 2 2 2 2 0 2 2 0 0 0 3 3 3 3 3 3 3 0 2 4 4 4 2 2 2 2 2 2 2 2 2 2 0 0 2 0 2 0 4 1 1 0 3 3 
3 1 0 2 0 2 0 0 0 2 0 0 0 0 0 0 0 0 0 0 0 0 0 0 0 0 2 0 0 0 0 0 2 0 2 0 2 0 2 0 1 3 3 4 4 0 0 0 0 2 2 2 2 2 2 0 2 2 0 2 2 0 2 0 0 0 3 3 3 3 3 3 3 0 2 4 4 4 4 2 2 2 2 2 2 2 2 2 2 2 2 2 0 0 4 4 4 0 3 3 
3 1 0 2 0 2 0 2 2 2 0 2 2 2 2 2 2 2 2 2 2 2 2 2 2 2 2 0 2 2 2 0 2 0 2 0 2 0 2 0 1 3 3 1 4 4 0 0 0 2 0 2 0 2 2 2 2 2 2 2 2 2 0 0 0 0 3 3 3 3 3 3 3 0 2 2 4 4 4 4 2 2 2 2 2 2 2 2 2 0 2 2 0 0 0 0 0 0 3 3 
3 1 0 2 0 0 0 0 0 2 0 2 0 0 0 0 0 0 0 0 0 0 0 0 0 0 0 0 2 0 2 0 0 0 2 0 2 0 2 0 1 3 3 1 1 4 4 0 0 0 2 2 2 2 2 2 2 2 2 2 0 2 0 0 0 0 3 3 3 3 3 3 3 0 0 2 4 4 4 4 4 4 2 2 2 2 2 2 2 2 2 2 2 0 0 2 0 0 3 3 
3 1 0 0 0 2 2 2 0 2 0 2 2 2 2 2 2 0 2 2 2 2 2 2 0 2 2 2 2 0 2 2 2 2 2 0 2 2 2 0 1 3 3 1 1 1 4 4 0 0 0 2 2 2 2 2 2 2 2 2 2 2 2 0 0 0 3 3 3 3 3 3 3 0 0 2 2 4 4 4 4 4 4 4 2 2 2 2 2 2 0 2 2 0 2 0 0 0 3 3 
3 3 1 1 0 0 0 2 0 0 0 2 0 0 0 0 0 0 2 0 0 0 0 0 0 2 0 0 0 0 2 0 0 0 0 0 0 0 2 0 1 3 3 1 1 1 1 4 4 4 0 2 2 0 2 0 2 2 2 2 2 2 2 0 0 0 3 3 3 3 3 3 3 0 0 0 2 2 2 4 4 4 4 4 4 4 2 2 2 2 2 2 2 2 2 0 0 0 3 3 
3 3 3 3 1 0 0 2 2 2 0 2 2 2 2 2 2 2 2 2 2 2 2 2 2 2 2 2 2 0 2 2 2 2 0 2 2 2 2 0 1 3 3 1 1 1 1 1 4 4 4 0 0 0 0 2 2 2 2 2 0 0 0 0 0 0 0 0 3 3 3 3 0 0 2 0 0 0 2 2 2 2 4 4 4 4 4 4 2 2 2 2 2 2 2 2 0 0 3 3 
3 3 3 3 3 1 0 0 0 2 0 0 0 0 0 2 0 0 0 0 0 0 0 2 0 0 0 0 0 0 0 0 0 2 0 2 2 2 0 0 1 3 3 1 1 1 1 1 1 4 4 0 0 0 0 2 2 0 2 0 0 0 2 0 0 0 0 0 3 3 3 3 3 0 0 0 0 2 0 2 2 2 2 2 4 4 4 4 2 2 2 0 2 2 0 2 0 0 3 3 
3 3 3 3 3 3 1 1 0 2 2 2 2 2 2 2 2 2 2 0 2 2 2 2 2 2 2 2 2 0 2 2 2 2 0 2 2 2 0 1 1 3 3 3 3 1 1 1 1 1 4 4 0 0 0 0 0 0 2 0 2 0 0 0 0 2 0 3 3 3 3 3 3 3 0 0 0 0 0 0 0 0 0 2 2 2 4 4 2 2 2 2 2 2 2 2 0 2 0 3 
3 3 3 3 3 3 3 1 0 0 2 0 0 0 0 0 0 0 0 0 0 0 0 0 0 0 0 0 2 0 2 0 0 0 0 0 0 0 0 1 1 3 3 3 3 3 3 3 1 1 4 4 0 0 2 0 0 0 0 0 0 0 0 0 0 0 0 3 3 3 3 3 3 3 3 3 3 3 3 0 0 0 0 0 0 2 2 2 2 2 2 2 0 2 0 0 0 0 0 3 
3 3 3 3 3 3 3 1 1 0 2 2 2 2 2 2 2 0 2 2 2 2 2 2 2 2 2 2 2 0 2 2 2 2 2 2 2 2 0 1 3 3 3 3 3 3 3 3 3 1 4 4 0 0 0 0 0 0 0 0 0 0 0 0 0 3 3 3 3 3 3 3 3 3 3 3 3 3 3 3 3 3 3 3 0 0 0 0 0 0 0 0 0 0 0 0 0 0 0 3 
3 3 3 3 3 3 3 3 3 3 0 0 0 0 0 0 0 0 0 0 0 0 0 0 0 0 0 0 0 0 0 0 0 0 0 0 0 0 0 1 3 3 3 3 3 3 3 3 3 3 3 3 3 3 3 3 3 3 3 3 3 3 3 3 3 3 3 3 3 3 3 3 3 3 3 3 3 3 3 3 3 3 3 3 3 3 3 3 3 3 3 3 3 3 3 3 3 3 3 3 
